Addington Highlands: Henry Hogg
Adelaide Metcalfe: Kurtis Smith
Adjala–Tosorontio: Floyd Pinto
Admaston/Bromley: Michael Donohue
Ajax: Shaun Collier
Alberton: Michael Ford
Alfred and Plantagenet: Stéphane Sarrazin
Algonquin Highlands: Carol Moffatt
Alnwick/Haldimand: John Logel
Amaranth: Bob Currie
Amherstburg: Aldo DiCarlo
The Archipelago: Bert Liverance
Armour: Bob MacPhail
Armstrong: Jean-Marc Boileau
Arnprior: Walter Stack
Arran-Elderslie: Steve Hammell
Ashfield–Colborne–Wawanosh: Glen McNeil
Asphodel-Norwood: Rodger Bonneau
Assiginack: David Ham
Athens: Herb Scott
Atikokan: Dennis Brown
Augusta: Doug Malanka
Aurora: Tom Mrakas
Aylmer: Mary French
Baldwin: Vern Gorham
Bancroft: Paul Jenkins
Barrie: Jeff Lehman
Bayham: Ed Ketchabaw
Beckwith: Richard Kidd
Belleville: Mitch Panciuk
Billings: Joseph Ian Anderson
Black River-Matheson: Gilles Laderoute
Blandford-Blenheim: Mark Peterson
Blind River: Sally Hagman
Blue Mountains: Alar Soever
Bluewater: Paul Klopp
Bonfield: Randall McLaren
Bonnechere Valley: Jennifer Murphy
Bracebridge: Graydon Smith
Bradford West Gwillimbury: Rob Keffer
Brampton: Patrick Brown
Brant: David Bailey
Brantford: Kevin Davis
Brethour: David White
Brighton: Brian Ostrander
Brock: Debbie Bath-Hadden
Brockton: Chris Peabody
Brockville: Jason Baker
Brooke-Alvinston: David Ferguson
Bruce Mines: Lory Patteri
Brudenell, Lyndoch and Raglan: Sheldon Keller
Burk's Falls: Cathy Still
Burlington: Marianne Meed Ward
Burpee and Mills: Ken Noland
Caledon: Allan Thompson
Callander: Hector Lavigne
Calvin: Ian Pennell
Cambridge: Kathryn McGarry
Carleton Place: Douglas Black
Carling: Mike Konoval
Carlow/Mayo: Bonnie Adams
Casey: Guy Labonté
Casselman: Daniel Lafleur
Cavan-Monaghan: Scott McFadden
Central Elgin: Sally Martyn
Central Frontenac: Frances Smith
Central Huron: Jim Ginn
Central Manitoulin: Richard Stephens
Centre Hastings: Tom Deline
Centre Wellington: Kelly Linton
Chamberlain: Kerry Stewart
Champlain: Normand Riopel
Chapleau: Michael Levesque
Chapple: Rilla Race
Charlton and Dack: Merrill Bond
Chatham-Kent: Darrin Canniff
Chatsworth: Scott Mackey
Chisholm: Leo Jobin
Clarence-Rockland: Guy Desjardins
Clarington: Adrian Foster
Clearview: Doug Measures
Cobalt: George Othmer
Cobourg: John Henderson
Cochrane: Denis Clement
Cockburn Island: Brenda Jones
Coleman: Dan Cleroux
Collingwood: Brian Saunderson
Conmee: Kevin Holland
Cornwall: Bernadette Clement
Cramahe: Mandy Martin
Dawn-Euphemia: Alan Broad
Dawson: Bill Langner
Deep River: Suzanne D'Eon
Deseronto: Dan Johnston
Dorion: Ed Chambers
Douro-Dummer: J. Murray Jones
Drummond/North Elmsley: Steve Fournier
Dryden: Greg Wilson
Dubreuilville: Beverly Nantel
Dutton/Dunwich: Bob Purcell
Dysart: Andrea Roberts
Ear Falls: Kevin Kahoot
East Ferris: Pauline Rochefort
East Garafraxa: Guy Gardhouse
East Gwillimbury: Virginia Hackson
East Hawkesbury: Robert Kirby
East Zorra-Tavistock: Don McKay
Edwardsburgh/Cardinal: Patrick Sayeau
Elizabethtown-Kitley: Brant Burrow
Elliot Lake: Dan Marchisella
Emo: Harold McQuaker
Englehart: Nina Wallace
Enniskillen: Kevin Marriott
Erin: Allan Alls
Espanola: Jill Beer
Essa: Sandie Macdonald
Essex: Larry Snively
Evanturel: Derek Mundle
Faraday: Dennis Purcell
Fauquier-Strickland: Madeleine Tremblay
Fort Erie: Wayne Redekop
Fort Frances: June Caul
French River: Gisèle Pageau
Front of Yonge: Roger Haley
Frontenac Islands: Denis Doyle
Gananoque: Ted Lojko
Gauthier: Marie Savarie
Georgian Bay: Peter Koetsier
Georgian Bluffs: Dwight Burley
Georgina: Margaret Quirk
Gillies: Wendy Wright
Goderich: John Grace
Gordon/Barrie Island: Lee Hayden
Gore Bay: Dan Osborne
Grand Valley: Steve Soloman
Gravenhurst: Paul Kelly
Greater Madawaska: Brian Hunt
Greater Napanee: Marg Isbester
Greater Sudbury: Brian Bigger
Greenstone: Renald Beaulieu
Grey Highlands: Paul McQueen
Grimsby: Jeff Jordan
Guelph: Cam Guthrie
Guelph/Eramosa: Chris White
Haldimand County: Ken Hewitt
Halton Hills: Rick Bonnette
Hamilton (city): Fred Eisenberger
Hamilton (township): Bill Cane
Hanover: Sue Paterson
Harley: Pauline Archambault
Harris: Chantal Desprès
Hastings Highlands: Vic Bodnar
Havelock-Belmont-Methuen: Jim Martin
Hawkesbury: Paula Assaly
Head, Clara and Maria: Debbi Grills
Hearst: Roger Sigouin
Highlands East: Dave Burton
Hilliard: Laurie Bolesworth
Hilton: Rodney Wood
Hilton Beach: Robert Hope
Hornepayne: Cheryl Fort
Horton: David Bennett
Howick: Doug Harding
Hudson: Larry Craig
Huntsville: Scott Aitchison
Huron East: Bernie MacLellan
Huron-Kinloss: Mitch Twolan
Huron Shores: Georges Bilodeau
Ignace: Donald Cunningham
Ingersoll: Ted Comiskey
Innisfil: Lynn Dollin
Iroquois Falls: Pat Britton
James: Terry Fiset
Jocelyn: Mark Henderson
Johnson: Blaine Mersereau
Joly: Tim Bryson
Kapuskasing: David Plourde
Kawartha Lakes: Andy Letham
Kearney: Carol Ballantyne
Kenora: Dan Reynard
Kerns: Terry Phillips
Killaloe, Hagarty and Richards: Janice Visneskie-Moore
Killarney: Ginny Rook
Kincardine: Anne Eadie
King: Steve Pellegrini
Kingston: Bryan Paterson
Kingsville: Nelson Santos
Kirkland Lake: Patrick Kiely
Kitchener: Berry Vrbanovic
La Vallee: Ken McKinnon
Laird: Dick Beitz
Lake of Bays: Terry Glover
Lake of the Woods: Colleen Fadden
Lakeshore: Tom Bain
Lambton Shores: Bill Weber
Lanark Highlands: Peter McLaren
Larder Lake: Patricia Quinn
LaSalle: Marc Bondy
Latchford: George Lefebvre
Laurentian Hills: John Reinwald
Laurentian Valley: Steve Bennett
Leamington: Hilda MacDonald
Leeds and the Thousand Islands: Corinna Smith-Gatcke
Limerick: Carl Stefanski
Lincoln: Sandra Easton
London: Ed Holder
Loyalist: Ric Bresee
Lucan Biddulph: Cathy Burghardt-Jesson
Macdonald, Meredith and Aberdeen Additional: Lynn Watson
Machar: Lynda Carleton
Machin: Gordon Griffiths
Madawaska Valley: Kim Love
Madoc: Loyde Blackburn
Magnetawan: Sam Dunnett
Malahide: Dave Mennill
Manitouwadge: John MacEachern
Mapleton: Gregg Davidson
Marathon: Richard Dumas
Markham: Frank Scarpitti
Markstay-Warren: Stephen Salonin
Marmora and Lake: Jan O'Neill
Matachewan: Anne Commando-Dubé
Mattawa: Dean Backer
Mattawan: Peter Murphy
Mattice-Val Côté: Marc Dupuis
McDougall: Dale Robinson
McGarry: Matt Reimer
McKellar: Peter Hopkins
McMurrich/Monteith: Ron Walton
McNab/Braeside: Thomas Peckett
Meaford: Barb Clumpus
Melancthon: Darren White
Merrickville-Wolford: Doug Struthers
Middlesex Centre: Aina DeViet
Midland: Stewart Strathearn
Milton: Gordon Krantz
Minden Hills: Brent Devolin
Minto: George Bridge
Mississauga: Bonnie Crombie
Mississippi Mills: Christa Lowry
Mono: Laura Ryan
Montague: Bill Dobson
Moonbeam: Nicole Fortier Lévesque
Moosonee: Wayne Taipale
Morley: George Heyens
Morris-Turnberry: Jamie Heffer
Mulmur: Janet Horner
Muskoka Lakes: Phil Harding
Nairn and Hyman: Laurier Falldien
The Nation: François St-Amour
Neebing: Erwin Butikofer
Newbury: Dianne Brewer
Newmarket: John Taylor
New Tecumseth: Rick Milne
Niagara Falls: Jim Diodati
Niagara-on-the-Lake: Betty Disero (Lord Mayor)
Nipigon: Richard Harvey
Nipissing: Tom Piper
Norfolk County: Kristal Chopp
North Algona Wilberforce: James Brose
North Bay: Al McDonald
North Dumfries: Sue Foxton
North Dundas: Tony Fraser
North Frontenac: Ron Higgins
North Glengarry: Jamie MacDonald
North Grenville: Nancy Peckford
North Huron: Bernie Bailey
North Kawartha: Carolyn Amyotte
North Middlesex: Brian Ropp
North Perth: Todd Kasenberg
North Shore: Randi Condie
North Stormont: Jim Wert
Northeastern Manitoulin and the Islands: Alan MacNevin
Northern Bruce Peninsula: Milt McIver
Norwich: Larry Martin
O'Connor: Jim Vezina
Oakville: Rob Burton
Oil Springs: Ian Veen
Oliver Paipoonge: Lucy Kloosterhuis
Opasatika: Denis Dorval
Orangeville: Sandy Brown
Orillia: Steve Clarke
Oro-Medonte: Harry Hughes
Oshawa: Dan Carter
Otonabee-South Monaghan: Joe Taylor
Ottawa: Jim Watson
Owen Sound: Ian Boddy
Papineau-Cameron: Robert Corriveau
Parry Sound: Jamie McGarvey
Pelee: Raymond Durocher
Pelham: Marvin Junkin
Pembroke: Michael LeMay
Penetanguishene: Doug Leroux
Perry: Norm Hofstetter
Perth: John Fenik
Perth East: Rhonda Ehgoetz
Perth South: Robert Wilhelm
Petawawa: Bob Sweet
Peterborough: Diane Therrien
Petrolia: Brad Loosley
Pickering: David Ryan
Pickle Lake: Dwight Monck
Plummer Additional: Beth West
Plympton–Wyoming: Lonny Napper
Point Edward: Bev Hand
Port Colborne: Bill Steele
Port Hope: Bob Sanderson
Powassan: Peter McIsaac
Prescott: Brett Todd
Prince: Ken Lamming
Prince Edward County: Steve Ferguson
Puslinch: James Seeley
Quinte West: Jim Harrison
Rainy River: Debbie Ewald
Ramara: Basil Clarke
Red Lake: Fred Mota
Red Rock: Gary Nelson
Renfrew: Don Eady
Richmond Hill: Dave Barrow
Rideau Lakes: Arie Hoogenboom
Russell: Pierre Leroux
Ryerson: George Sterling
Sables-Spanish Rivers: Leslie Gamble
St. Catharines: Walter Sendzik
St. Charles: Paul Schoppmann
St. Clair: Steve Arnold
St. Joseph: Jody Wildman
St. Marys: Al Strathdee
St. Thomas: Joe Preston
Sarnia: Mike Bradley
Saugeen Shores: Luke Charbonneau
Sault Ste. Marie: Christian Provenzano
Schreiber: Dave Hamilton
Scugog: Bobbie Drew
Seguin: Ann MacDiarmid
Selwyn: Andy Mitchell
Severn: Mike Burkett
Shelburne: Wade Mills
Shuniah: Wendy Landry
Sioux Lookout: Doug Lawrance
Sioux Narrows-Nestor Falls: Norbert Dufresne
Smiths Falls: Shawn Pankow
Smooth Rock Falls: Michel Arsenault
South Algonquin: Jane Dumas
South Bruce: Robert Buckle
South Bruce Peninsula: Janice Jackson
South Dundas: Steven Byvelds
South Frontenac: Ron Vandewal
South Glengarry: Frank Prevost
South Huron: George Finch
South River: Jim Coleman
South Stormont: Bryan McGillis
Southgate: John Woodbury
Southwest Middlesex: Allan Mayhew
South-West Oxford: David Mayberry
Southwold: Grant Jones
Spanish: Jocelyne Bishop
Springwater: Don Allen
Stirling-Rawdon: Bob Mullin
Stone Mills: Eric Smith
Stratford: Dan Mathieson
Strathroy-Caradoc: Joanne Vanderheyden
Strong: Kelly Elik
Sundridge: Lyle Hall
Tarbutt: Chris Burton
Tay: Ted Walker
Tay Valley: Brian Campbell
Tecumseh: Gary McNamara
Tehkummah: David Jaggard
Temagami: Dan O'Mara
Temiskaming Shores: Carman Kidd
Terrace Bay: Jody Davis
Thames Centre: Alison Warwick
Thessalon: Bill Rosenberg
Thornloe: Earl Read
Thorold: Terry Ugulini
Thunder Bay: Bill Mauro
Tillsonburg: Stephen Molnar
Timmins: George Pirie
Tiny: George Cornell
Toronto: John Tory
Trent Hills: Bob Crate
Trent Lakes: Janet Clarkson
Tudor and Cashel: Libby Clarke
Tweed: Jo-Anne Albert
Tyendinaga: Rick Phillips
Uxbridge: Dave Barton
Val Rita-Harty: Johanne Baril
Vaughan: Maurizio Bevilacqua
Wainfleet: Kevin Gibson
Warwick: Jackie Rombouts
Wasaga Beach: Nina Bifolchi
Waterloo: Dave Jaworsky
Wawa: Ron Rody
Welland: Frank Campion
Wellesley: Joe Nowak
Wellington North: Andy Lennox
West Elgin: Duncan McPhail
West Grey: Christine Robinson
West Lincoln: David Bylsma
West Nipissing: Joanne Savage
West Perth: Walter McKenzie
Westport: Robin Jones
Whitby: Don Mitchell
Whitchurch–Stouffville: Iain Lovatt
White River: Angelo Bazzoni
Whitestone: Chris Armstrong
Whitewater Region: Michael Moore
Wilmot: Les Armstrong
Windsor: Drew Dilkens
Wollaston: Barbara Shaw
Woodstock: Trevor Birtch
Woolwich: Sandy Shantz
Zorra: Marcus Ryan

